C 	25,0,25
WE maps/test_map.cub
EA maps/test_map.cub
SO maps/test_map.cub
F 00000,00000,00000
NO maps/test_map.cub

11111
11111
111111111111111111111111111111111111111111
1    1
1										 1
1										 1
1111111111111111111111111111111111111111111
1111111111111111111111111
1000000000110000000000001
1011000001110000000000001
100100000011000000000000000111111111
111111111011000001110000000000001
100000000011000001110111111111111
11110111111111011100000010001
11110111111111011101010010001
110E00000110101011100000010001
10000000000000001100000010101
11000001110101011111011110011
11110111 1110101 101111010001
11111111 1111111 111111111111
